************||************
*||||*|||||*||*|||||*||||*
*||||*|||||*||*|||||*||||*
*||||*|||||*||*|||||*||||*
**************************
*||||*||*||||||||*||*||||*
*||||*||*||||||||*||*||||*
******||****||****||******
|||||*|||||-||-|||||*|||||
|||||*|||||-||-|||||*|||||
|||||*||----------||*|||||
|||||*||-||||||||-||*|||||
|||||*||-||||||||-||*|||||
+----*---||||||||---*----+
|||||*||-||||||||-||*|||||
|||||*||-||||||||-||*|||||
|||||*||-||||||||-||*|||||
|||||*||----------||*|||||
|||||*||-||||||||-||*|||||
************||************
*||||*|||||*||*|||||*||||*
*||||*|||||****|||||*||||*
***||****************||***
||*||*||*||||||||*||*||*||
||*||*||*||||||||*||*||*||
******||****||****||******
*||||||||||*||*||||||||||*
*||||||||||*||*||||||||||*
**************************
